###############
#S.....XXXX..S#
#.#.#.#X#.#.#.#
#.XX..XXX.....#
#X#.#.#.#.#.#.#
#.......X.....#
#X#.#.#X#.#.#.#
#.....X.X.....#
#.#X#.#.#X#.#.#
#........XX...#
#.#.#X#.#.#.#.#
#XX..X.X..XX..#
#.#.#.#.#.#X#.#
#S..X......X.S#
###############