###############
#S00000000000S#
#0#0#0#0#0#0#0#
#0000000000000#
#0#0#0#0#0#0#0#
#0000000000000#
#0#0#0#0#0#0#0#
#0000000000000#
#0#0#0#0#0#0#0#
#0000000000000#
#0#0#0#0#0#0#0#
#0000000000000#
#0#0#0#0#0#0#0#
#S00000000000S#
###############