###############
#S...........S#
#.#.#.#.#.#.#.#
#.............#
#.#.#.#.#.#.#.#
#.............#
#.#.#.#.#.#.#.#
#.............#
#.#.#.#.#.#.#.#
#.............#
#.#.#.#.#.#.#.#
#.............#
#.#.#.#.#.#.#.#
#S...........S#
###############