###############
#S.....XXXX...#
#.#.#.#X#.#.#.#
#.XX..XXX.....#
#X#.#.#.#.#.#.#
#.......X.....#
#X#.#.#X#.#.#.#
#.....X.X.....#
#.#X#.#.#X#.#.#
#........XX...#
#.#.#X#.#.#.#.#
#XX..X.X..XX..#
#.#.#.#.#.#X#.#
#...X......X.S#
###############