###############
#S.XXXXXXXXXXX#
#.#X#X#X#X#X#X#
#XXXXXXXXXXXXX#
#X#X#X#X#X#X#X#
#XXXXXXXXXXXXX#
#X#X#X#X#X#X#X#
#XXXXXXXXXXXXX#
#X#X#X#X#X#X#X#
#XXXXXXXXXXXXX#
#X#X#X#X#X#X#X#
#XXXXXXXXXXXXX#
#X#X#X#X#X#X#.#
#XXXXXXXXXXX.S#
###############