###############
#S.XXEXXXRXXXX#
#.#X#X#X#R#X#X#
#RXXXXEXXXXXXX#
#X#X#X#X#X#X#X#
#XXRXEXXXEXXXX#
#X#X#X#R#X#X#X#
#XXREXXXXEXXXX#
#X#X#X#X#X#X#X#
#XXXEXXXRXXXXX#
#X#X#X#X#E#X#X#
#XXXEEXXXXRXXX#
#X#X#X#X#X#R#.#
#XXXXEXXXEXE.S#
###############